xxxxxxxxxxx
x       r x
x x xxx x x
x    s    x
x x x x xbx
x    r    x
x x xxx x x
x   ...e  x
xxxxxxxxxxx