xxxxxxxxxxx
x       r x
x x xxx xxx
x    s    x
x x x x xbx
x    r  x x
x x xxxxx x
x?  ...e  x
xxxxxxxxxxx