xxxxxxxxxxxxxxxxxxxxxxx
x s               ....x
x x x x x x x x x x x x
x        r      xb    x
x x x x x x x x x x x x
x    x.....     x    bx
x x x x x x x x x x x x
x          ......     x
x x x x x x x x x x x x
x    bx   r           x
x x x x x x x x x x x x
x.... .  r   .....    x
x x x x x x x x x x x x
x    r      x         x
x x x x x x x x x x x x
x    .....            x
x x x?x x x x x x x x x
x     .....  b       ex
xxxxxxxxxxxxxxxxxxxxxxx