xxxxxxxxxxxxxxxxxxxxxxxxxxxxxxxxxxxxxxxxxxxxxx
x s               ....x     .....  r       exx
x x x x x x x x x x x x x x?x x x x.x x x x xx 
x        r      xb    x    .....            xx
x x x x x x x x x x x x x x x x x x x x x x xx 
x    x.....     x    bxx          . ....     x
x x x x x x x x x x x x x x x x x x x x x x xx  
x          ......     xx      ..   b ...     x
x x x x x x x x x x x x x x x x x x x x x x xx  
x    bx   r     x     xx   .....             x
x x x x x x x x x x x x x x x x x x x x x x xx  
x.... .  r   .....    xx b   x   r       b   x
x x x x x x x x x x x x x x x x x x x x x x xx  
x    r      x         xx    x.....     x     x
x x x x x x x x x x x x x x x x x x x x x x xx  
x    .....            xx        r      x     x
x x x?x x x x x x x xx x x x x x x x x x x xxx 
x     .....  bx    r         r    ......    ?x
xxxxxxxxxxxxxxxxxxxxxxxxxxxxxxxxxxxxxxxxxxxxxx
